#############
#.....#.....#
#.....#...!.#
#..@..#O....#
#......######
#...........#
#........H..#
#...........#
#############
