      ###
     #O.#
    #.#.#
   #.##.#
  #.# #.#
 #.#  #.#
#.#####B####
#H.......@.#
#######.###
     # #
     #.#
     #.##
    #.!.#
    ####
