         ########
#########.......#
#........##### .#
#.   .##.     .#
#@#..#  O    .#
##. O#  .## .#
#!#H........#
############
