#####
#...#####
#.@..#.!##
#.....##.##
#...O.....##
#..D.###...##
##...# #...D#
 ##### ######
