#####
#...#####
#....#.!##
#. . .##.##
#...O.#...##
#.@D.###.O.##
##...# #...D#
 ####.#.#####
    # . #
     # #
