#####
#...#####
#.@..#.!##
#. . .##.##
#...O.#...##
#..D.###.O.##
##...# #...D#
 ####.#.#####
    # . #
     # #
