         ########
#########.......#
#........######.#
#.###.##.#   #.#
#@#..# #O#  #.#
##.#O###.###.#
#!#H........#
############
