 ####   #####
##..## ##...#
#.@..###..!.#
#....#O....##
##....#######
 ###........#
   ##....H..#
    ###....##
      ######
