##########
#........#
#.###..#.#
#@#..###.#
##.#O###.#
#!#H.....#
##########
