 ######
##.@.###
#...#.##
#.D###.##
#####O..#
   ##..##
  ##.#D#
  ###.##
   ##..#
######D.#
#D.#!#..#
#D..##.O#
##....##
 ##.O.#
  #####
