   #####
  ##H..##
 ##..@ . #
##.# D  . #
 .  B .  .
# .  .  . #
 .  B .  .!
# B  .  . #
 # B.... #
  ##DO.##
   # # #
