High noon
In jump mode, crates will also jump.
     ####
   ##....##
  #  ...   #
 #.  ...   .#
 #.  ..... .#
#..  ..... ..#
#!.  .@.   ..#
#..  .J.   ..#
#..  ... B...#
 #.  ... ...#
 #.  ...   .#
  #  ...   #
   ##....##
     ####
