Baker's dozen
Relax, and get a view of the situation.
 #########
###.#...###
###J#.#..##
###.#####.#
###O###..##
###.#...###
###@##...##
### ###..##
###.#B##..#
###.##...##
###!##..###
 #########
