Dancing queen

############
#..#.......#
#..#....@..#
#..#####...#
#..#  #...#
#..# #...#
#..##...#
#..#...#
#..#..#
#######
