Two paths
If you get stuck, you will have to (R)estart
 ##########
#.........#
#.........#
##.#####.#
 #..# #..#
 #..# #..#
 #..# #..#
 #..# #..#
 #.####H.##
##..@#O#..#
#!#...#...#
##########
