 ##########
#.........#
#.........#
##.#####.#
 #..# #..#
 #..# #..#
 #..# #..#
 #..# #..#
 #.#####.##
##..@#....#
#!#..O#H..#
##########
