Double helices
No matter how many obstacles cross your path, you can overcome them.
         ########    ####
#####   #...#...##  #...#
#S..#. .#...#O...## #...#
##.B#   #..###....# #..#
 ##..# #..#  ##.H.##..#
  ##..#..#    ##..#..#
   ##.@.#      ##.J.#
    #...##      #...##
   #..#..##    #..#..##
  #..##O.S#. .#S.###..#
  #..###..#####..# #..##
 #.B#   #...#O..#  ##..#
#...#. .#O..#..O#   #.S#
#..#    ####.#D.#   ####
#S#        #####
##


                      !
