Catch-22*
*Level is not actually a catch-22
              ! .
  #####  #####
 #S.H.###....## S
#......#......#
#..##..#..##..#
### #..### #..#
  .#.@#   #..#
  #.S#. .#J.#
 #..#####..####
#..B...#.....O#
#......#....D.#
###############
          S
