Title
Description
  #####      #####
 #....##    #H...##
#...@..#   #.S##..#
#D.##..#####.# .#.#  !
### #..#J#.##.##B.#
   S#.# #.# #....# 
### #.##S#S#.B##.##
#D###.D#####.#  #.#
#OB....#   #OO##..#
##.....#   ##J....#
 ######     ######
