Happy 26th birthday, Icha!
Love you very much!

    #####  #####
  ##....###....###
 #.......#.......##
#.BBB.BBB.B.B.BBB.#
#.OBD.BJ..BBB.B.B.#
#.OBD.B...BHB.BBB.#
#.BBB.BBB.B.B.BSB.#
#........@........#
#.....####.####...#
##...#   ##   #..#
 ##.# ## # ####.#
  ####.# #    ##
   ##.# ## ## #
    ## ### ## #
    #    #    #
    ##########
       ##.#
        ##














               !
