5 pads
Sometimes boxes are just in the way.
##########
#........#
#.@......#
#..B######
#... H
#..O######
#........#
#......D.#
#######..#
     #.###
     #...#
#.####.O.#
#!B.....D#
##.......#
##########
