 #######
##..H..##
#.......#
#..#### #
#..# #!##
#..#
#..#####
#...@D.##
##....O.#
##B###  #
##.# #BB#
##.# #..#
##.###..#
#.......#
#####..##
 #######
