Uroboros
Other times, they're harder than they look.
   #### H  ####
  #....#  #....#
 #......##......#
#..###B.....##...#
#..#! #.@..#  #..#
#..#  #..OO#  #..#
#..B###.....##B..#
 #.....D##D.....#
  #....#  #....#
   ####    ####
