   ####    ####
  #....#  #....#
 #......##...H..#
#...##B.....##...#
#..#  #.@..#  #..#
#..# D#....# !#..#
#...##......###..#
 #.....B##..D...#
  #....#  #....#
   ####    ####
