################
#....#....#....#
#.DD.#.O..#....#
 #..# #..# #.#
 #..#  #..#.#
 #..# ! #..#
 #..#   #..#
 #..#  #.#..#
 #..###.# #..#
#.@..BB..#..H.#
#OO......#....#
###############
